R 1024 768
F 122,122,122
C 255,200,160
SO ./textures/snow_side.xpm       
WE ./textures/dirt_side.xpm  
EA ./textures/my_side.xpm  
NO ./textures/grass_side.xpm
S  ./sprites/cookie.xpm


        1111111111111111111111111
        1000000000110000000000001
        1011000201110000000000001
        1001000000000000000002001
111111111011000001110000000000001
102000000011000001110111111111111
11110111111111011100000010001
11110111111111011101010010001
11000000110101011100000010001
10000000002000001100000010001
1000N000000000001101012010001
1100000111010101111101111000111
11110111 1112101 101111010001
11111111 1111111 111111111111
