R 1700 1100
F 122,122,122
C 160,193,211
SO ./textures/water.xpm       
WE ./textures/water.xpm  
EA ./textures/water.xpm  
NO ./textures/water.xpm
S  ./sprites/axolotl.xpm


        1111111111111111111111111
        1000000000110000000000001
        1011000S01110202202220221
        1001000000000020222002221
111111111011000001110002022220001
102000000011000001110111111111111
11110111111111011100000010001
11110111111111011101010010001
11000000110101011100000010001
10000002000000001100000010001
10002000000200001101012010001
1100000111010101111101111000111
11110111 1112101 101111010001
11111111 1111111 111111111111
